########################################
#11111111111111111111111111111111111111#
#11111111111111111111111111111111111111#
#1111@@111111111111111111111111111@@111#
#1111@@111111111111111111111111111@@111#
#11111111111@@@@@@@@@@@@@@@@@1111111111#
#11111111111@@@@@@@@@@@@@@@@@1111111111#
#1111@@111111111111111111111111111@@111#
#1111@@111111111111111111111111111@@111#
#1111@@111111111111111111111111111@@111#
#1111111111@@@@@@@1111111@@@@@@11111111#
#1111111111@@@@@@@1111111@@@@@@11111111#
#1111@@111111111111111111111111111@@111#
#1111@@111111111111111111111111111@@111#
#1111@@111111111111111111111111111@@111#
#11111111111@@@@@@@@@@@@@@@@@1111111111#
#11111111111@@@@@@@@@@@@@@@@@1111111111#
#1111@@111111111111111111111111111@@111#
#1111@@111111111111111111111111111@@111#
#11111111111111111111111111111111111111#
#11111111111111111111111111111111111111#
########################################